ВТжЮе=ВРжЮе
ВСжЮ=ВСжЫ
ВЫЗ=ВЮЗ
ЗШЗЮ=ЗКЗЮ
ЗШж=ЗКж
ЗОКЗЃжЛ=ЗОКЗЃжУ
ЗХШИб=ЗУШИб
ЗХШСбЗИ=ЗУШСбЗИ
ЗЭУдШнд=ЗЭУдКнд
Ъбг Фдђ=Збг Фдђе
ЗгЃСЗШжС=ЗгЃСЗКжС
ЗгЃСЗШСнУ=ЗгЃСЗКСнУ
ЗШСЗЮ=ЗКСЗЮ
ИЗИЗЮжСн=ИЗИЗЫжСн
ИЗШСн=ИЗКСн
ИЗШбЗЮ=ИЗКбЗЮ
ИЗМдЗЮ=ИЗМдЗЫ
ИЮЌе=ИЫЌе
ИбЮжС=ИбЫжС
ИбнШ=ИбнК
ЃЗКжЫ=ЃЗКжЮ
КЗСЗЫ жКж=КСЮ ж КжСжЮ
ШЗСг=КЗСг
ШдИжС=КдИжС
ШЗУ=КЗУ
ШЗУ ЯИЗИ=КЗУ ЯИЗИ
КЗЮ=КЗЫ
ШЗЮ=КЗЮ
ШЗЮ=КЗЮ
ШЗЮПнУ=КЗЮПнУ
ШЗбЗС=КЗбЗС
ШЗжб=КЗжб
ШЗнС=КЗнС
ШИЗФнС=КИЗФнС
ШИСОжд=КИСОжд
ШИСТП=КИСТП
ШИСТнд=КИСТнд
ШЃЗдЌе=КЃЗдЌе
ШЃнПд=КЃнПд
ШЃЮ=КЃЮ
ШШгЗМ=ККгЗМ
ШСЗТ=КСЗТ
ШСЗТ=КСЗТ
ШСОжд=КСОжд
ШСЮше=КСЮше
ШФК=КФК
ШЫЗС=КЫЗС
ШжИнЮЗ=КжИнЮЗ
ШжЭЗд=КжЭЗд
ЌЗСЫ=ЌЗСЮ
ЌбЮжТ=ЌбЫжТ
ОШгн=ОКгн
ПжЫбж=ПжЮбж
РЫЗб=ТЫЗб
УжЮЗК=УжЫЗК
ЫбШнПд=ЫбКнПд
ЮЗШн=ЮЗКн
ЫЗСжЫжС=ЮЗСжЮжС
ЫИЗП=ЮИЗП
ЫПшЗСе=ЮПшЗСе
ЫПЫП=ЮПЮП
ЫПЫд=ЮПЫд
ЮСЗЮСжШ=ЮСЗЮСжК
ЫСКн=ЮСКн
ЫСФгЗб=ЮСФгЗб
ЫСЮ=ЮСЮ
ЫСге=ЮСге
ЫСжФ=ЮСжФ
ЮТЫЗд=ЮТЮЗд
ЫФЫСЮ=ЮФЮСЮ
ЮФбЗЫ=ЮФбЗЮ
ЮЭХ=ЮЭУ
ЫхбхЃ=ЮхбхЃ
ЫбдИе=ЮбдИе
ЫбнЗд=ЮбнЗд
ЫжСИЗЫе=ЮжСИЗЫе
ЫжСК=ЮжСК
ЮжКн=ЮжШн
ЫнЮЗМ=ЮнЮЗМ
ЮнгЗЫ=ЮнгЗЮ
бЗШЗСн=бЗКЗСн
бЫ=бЮ
бЫ жбжЫ=бЮ жбжЮ
бЫ бЫ=бЮ бЮ
бжКн=бжШн
гбЗШ=гбЗК
дЗХжС=дЗУжС
дУКжСн=дУШжСн
дЫ дЫ=дЮ дЮ
дЭШ=дЭК
дЭШЗбнд=дЭКЗбнд
жСЮбгИнПд=жСЫбгИнПд
жЫ жЫ=жЮ жЮ
Нбнг=ебнг
Нжбе=ежбе
НнТ=енТ
нЗШЗЮЗд=нЗКЗЮЗд
нЗбЫжТ=нЗбЮжТ
нСЫе=нСЮе
нЮжС=нЫжС
ВЮЗОЗд=ВЫЗОЗд
ВЮЗМСн=ВЫЗМСн
ВбЗПЗЮ=ВбЗПЗЫ
ЗхШСЗС=ЗхКСЗС
ЗШСнФ=ЗКСнФ
ЗУШеИЗдЗК=ЗУКеИЗдЗК
ЗУШОС=ЗУКОС
ЗнШЗбнЗ=ЗнКЗбнЗ
ЗнТе=ЗнРе
ИЗШжг=ИЗКжг
ИжТСМгеС=ИжРСМгеС
ЃШСЯИнС=ЃКСЯИнС
ЃШСТИжСђ=ЃКСТИжСђ
ШЗЖнУ=КЗЖнУ
ШЗИ=КЗИ
ШЗСг=КЗСг
ШЗбФ=КЗбФ
ШЗнИЗП=КЗнИЗП
ШИСЯ=КИСЯ
ШЃжС=КЃжС
ШОЗС=КОЗС
ШОЗСУКЗд=КОЗСУКЗд
ШСЗИбУ=КСЗИбУ
ШСФнТ=КСФнТ
ШСЮИе=КСЮИе
ШУжМ=КУжМ
ШжЗбФ=КжЗбФ
ШжУ=КжУ
ШжУн=КжУн
ШеСЗд=КеСЗд
ШегЗУИ=КегЗУИ
ШегжСЛ=КегжСЛ
ШнУЭжд=КнУЭжд
МЗИбХЗ=МЗИбУЗ
ОШЗ=ОКЗ
ОЗЭ=ОжЗЭ
Рдд=Тджд
УЗжМИбЗЮ=УЗжМИбЗЫ
ХЫП=УЫП
ХЮбЗИ=УЮбЗИ
ФИжСЮЗд=ФИжСЫЗд
ЪнХж=ЪнУж
ЫИЗП=ЮИЗП
ЮуСбЮ=ЮуСбЫ
ЮСеќВЮЗМ=ЮСеќВЫЗМ
ЯнЫИЗП=ЯнЮИЗП
бжШ=бжК
бжШ=бжК
